1111111
1PC1111
10011E1
1111111