111111
1P11C1
100101
100001
11E011
111111