1111111111
1E00C00P01
1111111111