1111111111
1E10000C01
1C10110111
1010C10101
1011110101
1000000001
1111010101
1C0101C101
100P0101C1
1111111111
1111111111