1111111111
1000100001
10P0100001
1000100001
1110000001
100000C001
1000E00001
1110000001
1000000001
1111111111