1111111111
1E100000C1
1010110111
1C10C10101
1011110101
1000000001
1111010101
1C0101C101
1P000101C1
1111111111
1111111111