1111111111
10000P0001
1000000001
1000000001
1000000001
100000C001
1000000001
1110000001
1E10000001
1111111111