111111111111111111111
1P0000001C00001000001
111011101110100001111
1010001010101111000C1
101011100000000101111
101010111111110100001
101010000001010101101
101010111101010100101
10100010C100010100101
100010100000010100101
10C1111001111101001C1
100000100100000100111
111101101101011110001
100C00001001001C10111
1111000010111000001C1
10000110101C101110001
110101001010000011011
100100101011111110001
10C100101000000000101
101110101110111110101
10000010000000C0101E1
111111111111111111111