111111111
100010001
10C010C01
100010001
100000001
1110P0111
100000001
100010001
10E010C01
100010001
111111111